1111111111111111111111111111111111111111111111111111111111111
1000000000000000000X00000000000001000011111100000000000011E11
1000000000111111000000000X0000000C000000000000001000000100011
1000000000000111111000001000000000000001000000000000000000111
1000000000111111000000000X0000000C00000100000000000000XXX0011
1000000000011111100000000X00000000000001000X00000000000X00111
1000000000111111000000000000000000000001000000000011111111111
100000000011111100X00000011110000C00000000000X000000000000011
100000000011111100X000000000011111111111111100000000000000011
100000000011111100X00000000000000000000000X000000000000000011
100000000000X000000000000011111111100000011111100000000000011
100000000000X001111111111100000000111111111111000000000000011
100000000000000000000000X000000000000001111110000C00011111111
1P000000000000000000X011111111111000X0001111110000000000X0011
1111111111111111111111111111111111111111111111111111111111111