111111111111111
100000N0000C001
100C0000P0N0001
11N1110N0011111
1E00000C0011111
111111111111111
