1111111111111111111111111111111111111111
1001000000000000000000000000000000000001
1001000000000000000000000000000000000001
1001000000000000000000000000000000000001
1001000000000000000000000000000000000001
1001000000000000000000000000000000000001
1001000000000000000000000000000000000001
1001000000000000000000000000000000000001
1001000000000000000000000000000000000001
1001000000000000000000000000000000000001
1001000000000000000000000000000000000001
1001000000000000000000000000000000000001
1000011111000000000000000000000000000001
1PC011E000000000000000000000000000000001
1001000000000000000000000000000000000001
1001000000000000000000000000000000000001
1001000000000000000000000000000000000001
1001000000000000000000000000000000000001
1001000000000000000000000000000000000001
1001000000000000000000000000000000000001
1111111111111111111111111111111111111111
