1111111111111
10010000001E1
1000010000001
1P1C010000001
1111111111111
