111111111111111111111
1C0000C1000C0000C0001
1001000001000001000C1
1000000100000100000E1
100101000000001000001
100100100010000010001
100000010001000C01001
100001C100010000000C1
100100000000100000001
1C01000100001000000C1
100010001000000000001
1000C00100001C0001001
1P00010000000C0000001
111111111111111111111