111111111111111
1E100CCC1C100P1
10000CCC1000001
1C000CCC0000001
111111111111111