111111111111111
1E100CCC0C000P1
10000CCC0C00P01
111111111111111