1111111
1E00PC1
1111111
10000X1
1000001
1111111