11111111111111111111
1N0000000000CN000001
1C000P000C0000N000E1
10000N000000000C0001
11111111111111111111
