11111111111111111111111111111111111111111
10010000000000000000000000000000000000001
10010000000000000000000000000000000000001
10010000000000000000000000000000000000001
10010000000000000000000000000000000000001
10010000000000000000000000000000000000001
10010000000000000000000000000000000000001
10010000000000000000000000000000000000001
10010000000000000000000000000000000000001
10010000000000000000000000000000000000001
10010000000000000000000000000000000000001
10010000000000000000000000000000000000001
10000111110000000000000000000000000000001
1PC011E0000000000000000000000000000000001
10010000000000000000000000000000000000001
10010000000000000000000000000000000000001
10010000000000000000000000000000000000001
10010000000000000000000000000000000000001
10010000000000000000000000000000000000001
10010000000000000000000000000000000000001
11111111111111111111111111111111111111111
