
1111111111111111
1100000000000001
1000001000100001
11100000000000C1
101E000000000001
1111111111111111
