111111111111111
1E100CCC1C100P1
10000CCC1000001
10000CCC0000011
111111111111111