11111111111111111111111111111111111111111111111111
10000000000000000000000000000000000000000000000001
10111111111111111111111111111111111111111111111001
10000000000000000000000000000000000000000000000001
10111011111111111111111111111111111111111111111001
10000010000000000000000000000000000000001000000001
10111010000011111111111111111111111111010000011001
10000010000010000000000000000000000001010000000001
10111011111111111111111111111111111111111111111001
10000000000000000000000000000000000000000000000001
10111011111111111111111111111111111111111111111001
10000000000000000000000000000000000000000000000001
10111111111111111111111111111111111111111111111001
10000000000000000000000000000000000000000000000001
10111011111111111111111111111111111111111111111001
10000010000010000000000000000000000001010000000001
10111010000011111111111111111111111111010000011001
10000010000000000000000000000000000000001000000001
10111011111111111111111111111111111111111111111001
100000000000000000000000000000000000000000000CEP01
11111111111111111111111111111111111111111111111111