11111111111111111
1E1X0000X00XXXXX1
10000000000000001
10000000C00000001
1P000X00000X00001
11111111111111111