111111111111111111111111111111111111111111111111111111111111
1E1X0000X00XXXXX000000XX000X0000X0000000X000000X000000X000X1
1000000000000000X000000000X0000000000000000X0000000000000X01
10000000C00000000000000000000000000000XXXX000000000X00000X01
1000000000000000X000000000X0000000000000000X0000000000000X01
10000000C00000000000000000000000000000XXXX000000000X00000X01
1000000000000000X000000000X0000000000000000X0000000000000X01
10000000C00000000000000000000000000000XXXX000000000000000X01
1000000000000000X000000000X0000000000000000X0000000000000X01
10000000C00000000000000000000000000000XXXX00000000X000000X01
1000000000000000X000000000X0000000000000000X0000000000000X01
10000000C00000000000000000000000000000XXXX00000000X000000X01
1000000000000000X000000000X0000000000000000X0000000000000X01
10000000C00000000000000000000000000000XXXX00000000X000000X01
1000000000000000X000000000X0000000000000000X0000000000000X01
10000000C00000000000000000000000000000XXXX00000000X000000X01
1000000000000000X000000000X000000000000000X00000000000000X01
10000000C00000000000000000000000000000XXX000000000X000000X01
1000000000000000X000000000X000000000000000X00000000000000X01
10000000C00000000000000000000000000000XXX000000000X000000X01
1000000000000000X000000000X000000000000000X00000000000000X01
10000000C0000000000000000000000000000XXXX000000000X000000X01
1000000000000000X000000000X000000000000000X00000000000000X01
10000000C0000000000000000000000000000XXXX000000000X000000X01
1000000000000000X000000000X000000000000000X00000000000000X01
10000000C0000000000000000000000000000XXXX000000000X000000X01
1000000000000000X000000000X000000000000000X00000000000000X01
10000000C0000000000000000000000000000XXXX000000000X000000X01
1P000000000X00000000000000000000000000000000XX0000X000X00001
111111111111111111111111111111111111111111111111111111111111
