111111111111111111111
1C00C0C1000C0C00C0001
10C100C00100C001000C1
100C000100C00100C00E1
10C10100C00C001C00001
1C010C1000100C0010001
1C00C00100C10C0C01001
100001C100010000C00C1
10C10C00C00C10C000001
1C01000100001000C00C1
10C10C01C00C00C000001
1000C00100001C0001001
1P00010C00000C0000001
111111111111111111111