1111111111111
1001000000E01
10000100X0001
1PCC010000001
1111111111111