111111111111111111111
1C00X0C1000C0X00C00X1
10X100X00100X001000C1
100X000100X00100X00E1
10X10100X00X001X00001
1X010X1000100X0010001
1X00X00100X10X0C01001
100001C100010000X00C1
10X10X00X00X10X000001
1C01000100001000X00C1
100X10X01X00X00X00001
1000C00100001C0001001
1P00010X00000C0000001
111111111111111111111