111111111111111
1E100CCC1C100P1
1000XCCC10X0001
1CX00CCC00X00X1
111111111111111