111111111111111
100000X0000C001
100C0000P0X0001
11X1110X0011111
1E00000C0011111
111111111111111
